E..X..X.......X
XX.X.XXX.XXXX.X
.X.X...X.XX...X
.X...X.X...XX..
.XXX.X.XXX.XXXX
.......X.......
X......X.XX.XX.
X.XXXXXXXXXXXX.
X.X..XX...XXXX.
X.XX.XX.X.XXX..
X....XX.X.XXX.X
.XXX.XX.X...X.X
..XX....XXX....
X.XXXXXX...XXX.
.........X....S
